0000000000000000000000000000
0000000000000000000000000000
0000000000000000000000000000
1111111111111111111111111111
1___1_________1________1___1
1_1_1_1111_11_1_111111_1_1_1
1_1_____11_11_1_11_______1_1
1_11111_11_11_1_11_1111111_1
1r_______*________________*1
1_11_1_11_11_11_11_11_1111_1
1_11_1_11_11_11_11_11_1111_1
1______11____11____11______1
111111_11111_11_11111_111111
000001_11111_11_11111_100000
000001_11__________11_100000
000001_11_11100111_11_100000
111111_11_1p0000o1_11_111111
1_________10000001_________1
111111_11_10000001_11_111111
000001_11_11111111_11_100000
000001_11__________11_100000
000001_11_11_11_11_11_100000
111111_11_11_11_11_11_111111
1____________11____________1
1_1111_11_11_11_11_11_1111_1
1_1111_11_11_11_11_11_1111_1
1___11_______s_____________1
1-1_11_11_11111111_11_1111_1
1_1_11_11____1_____________1
1_1_____1_11_1_11_1_1_1_11_1
1___111_1_11_1_11_1_1_1____1
1_1_101_1_11_1_11_1_1__111_1
1_*_101___11____________*_b1
1111101111111111111111111111
0000000000000000000000000000
0000000000000000000000000000